0 1 1 1 1 1 1 1 1 1 1 1 1 47 47 47 47 1 1 1 1 1 1 1 1 1 1 1 1 5
20 6 7 7 7 7 7 7 7 7 7 7 7 47 47 47 47 7 7 7 7 7 7 7 7 7 7 7 11 105
20 46 47 47 47 47 47 47 47 47 47 47 47 56 57 47 47 47 47 47 47 47 47 47 47 47 47 47 51 105
20 46 47 47 47 47 47 47 47 47 47 47 47 47 47 47 47 47 47 47 47 47 47 47 47 47 47 47 51 105
20 46 47 47 47 47 47 47 47 47 47 47 47 47 47 47 47 47 47 47 47 47 47 47 47 47 47 47 51 105
20 46 47 47 47 47 47 47 47 47 47 47 47 47 47 47 47 47 47 47 47 47 47 47 47 47 47 47 51 105
20 46 47 47 47 47 47 47 47 47 47 47 47 47 47 47 47 47 47 47 47 47 47 47 47 47 47 47 51 105
47 47 47 47 47 47 47 47 47 47 47 47 47 47 47 47 47 47 47 47 47 47 47 47 47 47 47 47 47 47
47 47 47 47 47 47 47 47 47 47 47 47 47 47 47 47 47 47 47 47 47 47 47 47 47 47 47 47 47 47
47 47 47 47 47 47 47 47 47 47 47 47 47 47 47 47 47 47 47 47 47 47 47 47 47 47 47 47 47 47
20 46 47 47 47 47 47 47 47 47 47 47 47 47 47 47 47 47 47 47 47 47 47 47 47 47 47 47 51 105
20 46 47 47 47 47 47 47 47 47 47 47 47 47 47 47 47 47 47 47 47 47 47 47 47 47 47 47 51 105
20 46 47 47 47 47 47 47 47 47 47 47 47 47 47 47 47 47 47 47 47 47 47 47 47 47 47 47 51 105
20 46 47 47 47 47 47 47 47 47 47 47 47 47 47 47 47 47 47 47 47 47 47 47 47 47 47 47 51 105
20 46 47 47 47 47 47 47 47 47 47 47 47 47 47 47 47 47 47 47 47 47 47 47 47 47 47 47 51 105
20 106 107 107 107 107 107 107 107 107 107 107 107 47 47 47 47 107 107 107 107 107 107 107 107 107 107 107 111 105
120 121 121 121 121 121 121 121 121 121 121 121 121 47 47 47 47 121 121 121 121 121 121 121 121 121 121 121 121 125

0 1 1 1 1 1 1 1 1 1 1 1 1 47 47 47 47 1 1 1 1 1 1 1 1 1 1 1 1 5
20 6 7 7 7 7 7 7 7 7 7 7 7 47 47 47 47 7 7 7 7 7 7 7 7 7 7 7 11 105
20 46 47 47 47 47 47 47 47 47 47 47 47 47 47 47 47 47 47 47 47 47 47 47 47 47 47 47 51 105
20 46 47 12 47 47 47 47 47 47 47 47 47 47 47 47 47 47 47 47 47 47 47 47 47 47 47 47 51 105
20 46 47 47 47 47 47 47 47 47 47 47 47 47 47 47 47 47 47 47 47 47 47 47 47 47 47 47 51 105
20 46 47 47 47 47 112 77 77 77 77 77 79 47 47 47 47 47 47 47 47 47 47 12 12 47 47 47 51 105
20 46 47 47 47 47 112 47 47 47 47 47 47 47 47 47 47 47 47 47 47 47 47 47 47 47 47 47 51 105
47 47 47 47 47 47 112 47 47 47 47 47 47 47 47 47 47 47 47 47 47 47 47 47 47 47 47 47 47 47
47 47 47 47 47 47 112 47 12 12 47 47 47 47 47 47 47 47 47 92 47 47 47 47 47 47 47 47 47 47
47 47 47 47 47 47 112 47 47 47 47 47 47 47 47 47 47 47 47 132 47 47 47 47 47 47 47 47 47 47
20 46 47 47 47 47 112 47 47 47 47 47 47 47 47 47 47 47 47 132 47 47 47 47 47 47 47 47 51 105
20 46 47 47 47 47 152 47 47 47 47 47 47 47 47 47 76 77 77 77 79 47 47 47 47 47 47 47 51 105
20 46 47 47 47 47 47 47 47 47 47 47 47 47 47 47 47 47 47 47 47 47 47 47 47 47 47 47 51 105
20 46 47 47 47 47 47 47 47 47 47 47 47 47 47 47 47 47 47 47 47 47 47 47 47 47 47 12 51 105
20 46 47 12 47 47 47 47 47 47 47 47 47 47 47 47 47 47 47 47 47 47 47 47 47 47 12 12 51 105
20 106 107 107 107 107 107 107 107 107 107 107 107 47 47 47 47 107 107 107 107 107 107 107 107 107 107 107 111 105
120 121 121 121 121 121 121 121 121 121 121 121 121 47 47 47 47 121 121 121 121 121 121 121 121 121 121 121 121 125

0 1 1 1 1 1 1 1 1 1 1 1 1 47 47 47 47 1 1 1 1 1 1 1 1 1 1 1 1 5
20 6 7 7 7 7 7 7 7 7 7 7 7 47 47 47 47 7 7 7 7 7 7 7 7 7 7 7 11 105
20 46 12 47 47 47 47 47 12 47 47 47 47 47 47 47 47 47 47 47 47 47 47 47 47 47 47 47 51 105
20 46 47 47 47 47 47 47 47 47 47 47 12 47 47 47 47 47 47 47 47 47 47 47 47 47 47 47 51 105
20 46 47 47 47 47 47 47 47 47 47 47 47 47 47 47 47 47 47 47 47 47 47 47 47 12 47 47 51 105
20 46 47 47 47 47 47 47 47 47 47 47 47 47 47 47 47 47 47 47 47 47 47 47 47 47 47 47 51 105
20 46 47 47 47 47 47 12 47 47 47 47 47 12 47 47 47 12 47 47 47 47 47 47 47 47 47 47 51 105
47 47 47 47 47 47 47 47 47 47 47 47 47 47 47 47 47 47 47 47 47 47 47 47 47 47 47 47 47 47
47 47 47 47 47 47 47 47 47 47 47 47 47 47 47 47 47 47 47 47 47 47 47 47 47 47 47 47 47 47
47 47 47 47 47 47 47 47 47 47 47 47 47 47 47 47 47 47 47 47 47 47 47 12 47 47 47 47 47 47
20 46 47 47 47 47 47 47 47 47 47 47 47 47 47 47 47 47 47 47 47 47 47 47 47 47 47 47 51 105
20 46 47 47 47 12 47 47 47 47 47 47 47 12 47 47 47 47 47 47 47 47 47 47 47 47 47 47 51 105
20 46 47 47 47 47 12 47 47 47 47 47 47 47 47 47 47 47 47 47 47 47 47 47 47 47 47 47 51 105
20 46 47 47 47 47 47 12 47 47 47 47 47 47 47 47 47 47 47 47 47 47 47 47 47 12 47 47 51 105
20 46 47 47 47 47 47 47 47 47 47 47 47 47 47 47 47 47 47 12 12 47 47 47 47 47 47 47 51 105
20 106 107 107 107 107 107 107 107 107 107 107 107 47 47 47 47 107 107 107 107 107 107 107 107 107 107 107 111 105
120 121 121 121 121 121 121 121 121 121 121 121 121 47 47 47 47 121 121 121 121 121 121 121 121 121 121 121 121 125

0 1 1 1 1 1 1 1 1 1 1 1 1 47 47 47 47 1 1 1 1 1 1 1 1 1 1 1 1 5
20 6 7 7 7 7 7 7 7 7 7 7 7 47 47 47 47 7 7 7 7 7 7 7 7 7 7 7 11 105
20 46 12 12 47 47 47 47 47 47 47 47 47 47 47 47 47 47 47 47 47 47 47 47 47 47 12 12 51 105
20 46 12 47 47 47 47 47 47 47 47 47 47 47 47 47 47 47 47 47 47 47 47 47 47 47 47 12 51 105
20 46 47 47 47 47 47 47 47 47 12 47 47 47 47 47 47 47 47 12 47 47 47 47 47 47 47 47 51 105
20 46 47 47 47 47 47 47 47 47 47 47 77 77 77 77 77 77 47 47 47 47 47 47 47 47 47 47 51 105
20 46 47 47 47 47 47 47 47 47 77 77 112 47 47 47 47 112 77 77 47 47 47 47 47 47 47 47 51 105
47 47 47 47 47 47 47 47 47 47 112 47 112 47 47 47 47 112 47 112 47 47 47 47 47 47 47 47 47 47
47 47 47 47 47 47 47 47 47 47 112 47 112 47 47 47 47 112 47 112 47 47 47 47 47 47 47 47 47 47
47 47 47 47 47 47 47 47 47 47 112 47 112 47 47 47 47 112 47 112 47 47 47 47 47 47 47 47 47 47
20 46 47 47 47 47 47 47 47 47 77 77 112 47 47 47 47 112 77 77 47 47 47 47 47 47 47 47 51 105
20 46 47 47 47 47 47 47 47 47 47 47 77 77 77 77 77 77 47 47 47 47 47 47 47 47 47 47 51 105
20 46 47 47 47 47 47 47 47 47 12 47 47 47 47 47 47 47 47 12 47 47 47 47 47 47 47 47 51 105
20 46 12 47 47 47 47 47 47 47 47 47 47 47 47 47 47 47 47 47 47 47 47 47 47 47 47 12 51 105
20 46 12 12 47 47 47 47 47 47 47 47 47 47 47 47 47 47 47 47 47 47 47 47 47 47 12 12 51 105
20 106 107 107 107 107 107 107 107 107 107 107 107 47 47 47 47 107 107 107 107 107 107 107 107 107 107 107 111 105
120 121 121 121 121 121 121 121 121 121 121 121 121 47 47 47 47 121 121 121 121 121 121 121 121 121 121 121 121 125

0 1 1 1 1 1 1 1 1 1 1 1 1 47 47 47 47 1 1 1 1 1 1 1 1 1 1 1 1 5
20 6 7 7 7 7 7 7 7 7 7 7 92 47 47 47 47 92 7 7 7 7 7 7 7 7 7 7 11 105
20 46 47 47 47 47 47 47 47 47 47 47 112 47 47 47 47 112 47 47 47 47 47 47 47 47 47 47 51 105
20 46 47 47 47 47 47 47 47 47 47 47 112 47 47 47 47 112 47 47 47 47 47 47 47 47 47 47 51 105
20 46 47 47 47 47 47 47 47 47 47 47 112 47 47 47 47 112 47 47 47 47 47 47 47 47 47 47 51 105
20 46 47 47 47 47 47 47 47 47 47 47 112 47 47 47 47 112 47 47 47 47 47 47 47 47 47 47 51 105
20 76 77 77 77 77 77 77 77 77 77 77 12 47 47 47 47 12 77 77 77 77 77 77 77 77 77 77 79 105
47 47 47 47 47 47 47 47 47 47 47 47 47 47 47 47 47 47 47 47 47 47 47 47 47 47 47 47 47 47
47 47 47 47 47 47 47 47 47 47 47 47 47 47 47 47 47 47 47 47 47 47 47 47 47 47 47 47 47 47
47 47 47 47 47 47 47 47 47 47 47 47 47 47 47 47 47 47 47 47 47 47 47 47 47 47 47 47 47 47
20 76 77 77 77 77 77 77 77 77 77 77 12 47 47 47 47 12 77 77 77 77 77 77 77 77 77 77 79 105
20 46 47 47 47 47 47 47 47 47 47 47 112 47 47 47 47 112 47 47 47 47 47 47 47 47 47 47 51 105
20 46 47 47 47 47 47 47 47 47 47 47 112 47 47 47 47 112 47 47 47 47 47 47 47 47 47 47 51 105
20 46 47 47 47 47 47 47 47 47 47 47 112 47 12 12 47 112 47 47 47 47 47 47 47 47 47 47 51 105
20 46 47 47 47 47 47 47 47 47 47 47 112 47 47 47 47 112 47 47 47 47 47 47 47 47 47 47 51 105
20 106 107 107 107 107 107 107 107 107 107 107 152 47 47 47 47 152 107 107 107 107 107 107 107 107 107 107 111 105
120 121 121 121 121 121 121 121 121 121 121 121 121 47 47 47 47 121 121 121 121 121 121 121 121 121 121 121 121 125

0 1 1 1 1 1 1 1 1 1 1 1 1 47 47 47 47 1 1 1 1 1 1 1 1 1 1 1 1 5
20 6 7 7 7 7 7 7 7 7 7 7 92 47 47 47 47 92 7 7 7 7 7 7 7 7 7 7 11 105
20 46 47 47 47 47 47 47 47 47 47 47 112 47 47 47 47 112 47 47 47 47 47 47 47 47 47 47 51 105
20 46 47 47 47 47 47 47 47 47 47 47 112 47 47 47 12 112 47 47 47 47 47 47 47 47 47 47 51 105
20 46 47 47 47 47 47 47 47 47 47 47 112 47 47 47 47 112 47 47 47 47 47 47 47 47 47 47 51 105
20 46 47 47 47 47 47 47 47 47 47 47 112 12 47 47 47 112 47 47 47 47 47 47 47 47 47 47 51 105
20 86 47 47 47 47 47 47 47 47 47 47 112 47 47 47 47 112 47 47 47 47 47 47 47 47 47 47 91 105
47 47 47 47 47 47 47 47 47 47 47 47 112 47 47 47 47 112 47 47 47 47 47 47 47 47 47 47 47 47
47 47 47 47 47 47 47 47 47 47 47 47 112 47 47 47 47 112 47 47 47 47 47 47 47 47 47 47 47 47
47 47 47 47 47 47 47 47 47 47 47 47 112 47 47 47 12 112 47 47 47 47 47 47 47 47 47 47 47 47
20 86 47 47 47 47 47 47 47 47 47 47 112 47 47 47 12 112 47 47 47 47 47 47 47 47 47 47 91 105
20 46 47 47 47 47 47 47 47 47 47 47 112 47 47 47 47 112 47 47 47 47 47 47 47 47 47 47 51 105
20 46 47 47 47 47 47 47 47 47 47 47 112 47 47 47 47 112 47 47 47 47 47 47 47 47 47 47 51 105
20 46 47 47 47 47 47 47 47 47 47 47 112 47 47 47 47 112 47 47 47 47 47 47 47 47 47 47 51 105
20 46 47 47 47 47 47 47 47 47 47 47 112 12 47 47 47 112 47 47 47 47 47 47 47 47 47 47 51 105
20 106 107 107 107 107 107 107 107 107 107 107 152 47 47 47 47 152 107 107 107 107 107 107 107 107 107 107 111 105
120 121 121 121 121 121 121 121 121 121 121 121 121 47 47 47 47 121 121 121 121 121 121 121 121 121 121 121 121 125

0 1 1 1 1 1 1 1 1 1 1 1 1 47 47 47 47 1 1 1 1 1 1 1 1 1 1 1 1 5
20 6 7 7 7 7 7 7 7 7 7 7 92 47 47 47 47 7 7 7 7 7 7 7 7 7 7 7 11 105
20 46 47 47 47 47 47 47 47 47 47 47 112 47 47 47 47 47 47 47 47 47 47 47 47 47 47 47 51 105
20 46 47 47 47 47 47 47 47 47 47 47 112 47 47 47 47 47 47 47 47 47 47 47 47 47 47 47 51 105
20 46 47 47 47 47 47 47 47 47 47 47 112 47 47 47 47 47 47 47 47 47 47 47 47 47 47 47 51 105
20 46 47 47 47 47 47 47 47 47 47 47 112 47 47 47 47 47 47 47 47 47 47 47 47 47 47 47 51 105
20 76 77 77 77 77 77 77 77 77 77 77 12 12 47 47 47 47 47 12 12 47 47 47 47 47 47 47 91 105
47 47 47 47 47 47 47 47 47 47 47 47 12 12 12 47 47 47 12 12 12 47 47 47 47 47 47 47 47 47
47 47 47 47 47 47 47 47 47 47 47 47 47 12 12 12 47 12 12 12 47 47 47 47 47 47 47 47 47 47
47 47 47 47 47 47 47 47 47 47 47 47 47 47 12 12 12 12 12 47 47 47 47 47 47 47 47 47 47 47
20 86 47 47 47 47 47 47 47 47 47 47 47 47 47 12 12 12 47 47 47 47 47 47 47 47 47 47 91 105
20 46 47 47 47 47 47 47 47 47 47 47 47 47 47 47 12 47 47 47 47 47 47 47 47 47 47 47 51 105
20 46 47 47 47 47 47 47 47 47 47 47 47 47 47 47 47 47 47 47 47 47 47 47 47 47 47 47 51 105
20 46 47 47 47 47 47 47 47 47 47 47 47 47 47 47 47 47 47 47 47 47 47 47 47 47 47 47 51 105
20 46 47 47 47 47 47 47 47 47 47 47 47 47 47 47 47 47 47 47 47 47 47 47 47 47 47 47 51 105
20 106 107 107 107 107 107 107 107 107 107 107 107 47 47 47 47 107 107 107 107 107 107 107 107 107 107 107 111 105
120 121 121 121 121 121 121 121 121 121 121 121 121 47 47 47 47 121 121 121 121 121 121 121 121 121 121 121 121 125
